            ############ #####################      #####################################       ####
            #           #                     ..........................#########                   
            #   ###                           .#   #                   .#                           
            ####                              .#   #         ########  ............................B
                                              . #  #                #                               
                                              . #  #                #                               
                                              . #  #                #                               
                              #               . # #                 ##                              
                              #               . # #               # ##                              
                              #               . # #             ### #####                           
                              #               . #  #            #       #                           
            ##                #               . #  ##############   #   #   #                       
            #####             # ##            . #               #       #                           
            ######                #           . ##               ####  #######################      
                                              . #                   #                        #      
            #                                 . #               #   #                        ####   
            ##                   .............. #                                               ####
            ##################   .################                                                  
                                 .                                                      ############
                                ..                                                                  
                                .#################################                       ####       
                                .                                                                   
                                .                                                                   
                                .                                                           ########
                                .                   ################################                
                                .                                               #                   
                                .                                               ############        
                                .                                                                   
         ###################### .                     ##                                            
                           ......                                                                   
                           .###########################                                             
                           .                                        ###########                     
                           .                                                                        
                           .                                                                        
                           .                                                                        
                           .                                                                        
                       .....                                                                        
                       .##############################                                              
                       .                                                                            
                       .                                                                            
                       .                                                                            
                       .                                                                            
                       .                                                                            
                       .                                        ####################################
                       .                    ##########                                              
                       .                    #####                                     #####         
                       .                        #                                 ####              
                       .                        #                             ####                  
               .........                        #                           ##                      
               .#############################################################                       
               .    #                                                                               
               .    #                                                                               
               .################                                                                    
               .............................................                                        
                                                           .                                        
                                                           .        ############################### 
                ##############                             .                                        
                                                           .                                        
                         ############                      .                                        
                                 ####                      .                                        
                               ####                        .                               #########
                             ####                          .                                        
                           ####                            .                                        
                         ####                              .                                        
                         ############                      .                                        
                                                           .                                        
                                                           .########################    ############
                    #                                      .........                                
                                                                   .                                
###########################################                        .    ############################
                                                                   .                                
                                                                   .                                
                                                                   .            #               ####
                        ###########################################.                                
                                                                   .                                
                                                                   .                                
                                                                   .                                
                                                                   .                                
                                    #######                        .                                
                                                                   .                                
        #####################################################      .                                
                                                                   .                                
                                       .............................                                
                                       .############################################                
                                       .........                                                    
                                               .                                                    
                                               .                ####################################
###############################################.                                                    
                                               .                                                    
                                               .                                                    
                                               .                                                    
                                       .........                                                    
                                       .##############                                              
                                       .                                                            
                                       .                                                            
#################                      .          ########                                          
                                       .            #                                               
                                       .            #    #                                          
#########################              .                                                            
A.......................................                                                            
