##############                                                                                      
#   # .......#                                                                                      
# A.# .#####.#                                                                                      
#  ....#  ##.#                                                                                      
######### #..#                                                                                      
#        B#.##                                                                                      
# ######..#..#                                                                                      
#   #  #.###.#                                                                                      
#   #   .....#                                                                                      
##############                                                                                      
                                                                                                    
