            ############ #####################      #####################################       ####
            #           #                                               #########                   
            #   ###                            #   #               .....#                           
            ####                               #   #         ######.#  ............................B
                                                #  #               .#                               
                                                #  #               .#                               
                                                #  #               .#                               
                              #                 # #                .##                              
                              #                 # #               #.##                              
                              #                 # #             ###.#####                           
                              #                 #  #            #  ...  #                           
            ##                #                 #  ##############   #.  #   #                       
            #####             # ##              #               #    .  #                           
            ######                #             ##               ####. #######################      
                                                #                   #.                       #      
            #                                   #               #   #.                       ####   
            ##                                  #                    .                          ####
            ##################    ################                   .                              
                                                                     .                  ############
                                                                     .                              
                                 #################################   .                   ####       
                                                                     .                              
                                                                     .                              
                                                   ...................                      ########
                                                   .################################                
                                                   .............                #                   
                                                               .                ############        
                                                               .                                    
         ######################                       ##       .                                    
                                                               .                                    
                            ###########################        .                                    
                                                               .    ###########                     
                                                               .                                    
                                                               .                                    
                                                               .                                    
                                                               .                                    
                                                               .                                    
                        ##############################         .                                    
                                                               .                                    
                                                               .                                    
                                                               .                                    
                                                               .                                    
                                                               .                                    
                                                               .####################################
                                            ##########         .....................................
                                            #####                                     #####        .
                                                #                                 ####             .
                                                #                             ####                 .
                                                #                           ##                     .
                #############################################################                      .
                    #                                                                              .
                    #                                                                              .
                ################                                                                   .
                                                                                                   .
                                                                                                   .
                                                                    ###############################.
                ##############                                                                     .
                                                                                                   .
                         ############                                                              .
                                 ####                                                     ..........
                               ####                                                       .#########
                             ####                                                         .         
                           ####                                                           .         
                         ####                                                             .         
                         ############                                                     .         
                                                                                       ....         
                                                            ########################   .############
                    #                                                                  .            
                                                                       .................            
###########################################                            .############################
                                                                       .                            
                                                                       .                            
                                                                       .        #               ####
                        ###########################################    .                            
                                                                       .                            
                                                                       .                            
                                                                       .                            
                                                                       .                            
                                    #######                            .                            
                                                                       .                            
        #####################################################          .                            
                                                                       .                            
                                       .................................                            
                                       .############################################                
                                       .........                                                    
                                               .                                                    
                                               .                ####################################
###############################################.                                                    
                                               .                                                    
                                               .                                                    
                                               .                                                    
                                       .........                                                    
                                       .##############                                              
                                       .                                                            
                                       .                                                            
#################                      .          ########                                          
                                       .            #                                               
                                       .            #    #                                          
#########################              .                                                            
A.......................................                                                            
