            ############ #####################      #####################################       ########
            #           #                                               #########
            #   ###                            #   #                    #
            ####                               #   #         ###### #                              B   #################
                                                #  #                #
                                                #  #                #
                                                #  #                #
                              #                 # #                 ##
                              #                 # #               # ##
                              #                 # #             ### #####
                              #                 #  #            #       #
            ##                #                 #  ##############   #   #   #
            #####             # ##              #               #       #
            ######                #             ##               ####  #######################
                                                #                   #                        #
            #                                   #               #   #                        ####
            ##                                  #                                               #####
            ##################    ################                                                  #
                                                                                        ##################

                                 #################################                       ####


                                                                                            ##########
                                                    ################################
                                                                                #
                                                                                ############

         ######################                       ##

                            ###########################
                                                                    ###########





                        ##############################





                                                                ##################################################
                                            ##########                                    
                                            #####                                     #####
                                                #                                 ####
                                                #                             ####
                                                #                           ##
                #############################################################
                    #
                    #
                ################


                                                                    ###############################
                ##############

                         ############
                                 ####
                               ####                                                        #################
                             ####
                           ####
                         ####
                         ############

                                                            ########################    #################################
                    #

###########################################                             #################################


                                                                                #               ##################
                        ###########################################

                                                                        


                                    #######

        #####################################################


                                        ############################################


                                                                ##################################################
###############################################




                                        ##############


#################                                 ########
                                                    #
                                                    #    #
#########################
A