############                                                                                        
#          #                                                                                        
#      A   #             B                                                                          
#          #                                                                                        
#          #                                                                                        
############                                                                                        